W W W W W W W W W W W W W W W W W W
W W W W W W W W W W W W W W W W W W
W W W W W W W W W W W W W W W W W W
W W W W W W W W W W W W W W W W W W
W W W W W W W W W W W W W W W W W W
W W W W W W b b b b W W W W W W W W
W W W W W W F F F F F W W W W W W W
W W W W W W F F F F F W W W W W W W
W W W W W W F F F F F W W W W W W W
W W W W W W B B F F F W W W W W W W
W W W W W W B B F F F W W W W W W W
W W W W W W F F F F F W W W W W W W
W W W W W W F F F F F W W W W W W W
W W W W W W F F F W W W W W W W W W
W W W W W W F P F W W W W W W W W W
W W W W W W F F F W W W W W W W W W
W W W W W W W W W W W W W W W W W W
W W W W W W W W W W W W W W W W W W
W W W W W W W W W W W W W W W W W W
W W W W W W W W W W W W W W W W W W