W W W W W W W W W W W W W W W W W W
W W W W W W W W W W W W W W W W W W
W W W W W W W W W W W W W W W W W W
W W W W W W W W W W W W W W W W W W
W W W W W W W W W W W W W W W W W W
W W W W W W W W W W W W W W W W W W
W W W W W W F F F F F F W W W W W W
W W W W W W F F F P F F W W W W W W
W W W W W W F F F F F F W W W W W W
W W W W W W F F R R R F W W W W W W
W W W W W W F F R R R F W W W W W W
W W W W W W F F R R R F W W W W W W
W W W W W W F F F F F F W W W W W W
W W W W W W F B B B B B W W W W W W
W W W W W W W W r r r W W W W W W W
W W W W W W W W r r r W W W W W W W
W W W W W W W W r r r W W W W W W W
W W W W W W W W W W W W W W W W W W
W W W W W W W W W W W W W W W W W W
W W W W W W W W W W W W W W W W W W