W W W W W W W W W W W W W W W W W W
W W W W W W W W W W W W W W W W W W
W W W W W W W W W W W W W W W W W W
W W W W W W W W W W W W W W W W W W
W W W W W W W W r r W W W W W W W W
W W W W W W W W r r W W W W W W W W
W W W W W W W W r r W W W W W W W W
W W W W W W b b b b W W W W W W W W
W W W W W W b b b b W W W W W W W W
W W W W W W F F F F W W W W W W W W
W W W W W W F F R R W W W W W W W W
W W W W W W F F R R W F F F W W W W
W W W W W W F F R R W F P F W W W W
W W W W W W F F F F W F F F W W W W
W W W W W W F F F F W F F F W W W W
W W W W W W F F F B B B B F W W W W
W W W W W W F F F B B B B F W W W W
W W W W W W F F F F F W W W W W W W
W W W W W W W W W W W W W W W W W W
W W W W W W W W W W W W W W W W W W