W W W W W W W W W W W W W W W W W W
W W W W W W W W W W W W W W W W W W
W W W W W W W W W W W W W W W W W W
W W W W W W W W W W W W W W W W W W
W W W W W W W W W W W W W W W W W W
W W W W W W W W W W W W W W W W W W
W W W W r r r r F y y y y W W W W W
W W W W V V V V V V V V V W W W W W
W W W W F F F F V F F F F W W W W W
W W W W F F F F V F F F F W W W W W
W W W W F F F F V F F F F W W W W W
W W W W F F F F V F F F F W W W W W
W W W W F F F B B B F F F W W W W W
W W W W R R R R V Y Y Y Y W W W W W
W W W W F F F F F F F F F W W W W W
W W W W F F F F P F F F F W W W W W
W W W W F F F F F F F F F W W W W W
W W W W W W W W W W W W W W W W W W
W W W W W W W W W W W W W W W W W W
W W W W W W W W W W W W W W W W W W