W W W W W W W W W W W W W W W W W W
W W W W W W W W W W W W W W W W W W
W W W W W W W W W W W W W W W W W W
W W W W W W W W W W W W W W W W W W
W W W W W W W W W W W W W W W W W W
W W W W W W F F F F W W W W W W W W
W W W W W W F F F F F W W W W W W W
W W W W W W F R R F F W W W W W W W
W W W W W W F R R F V W W W W W W W
W W W W W B B B B B F W W W W W W W
W W W W F F Y Y Y Y Y W W W W W W W
W W W W b F W F F F F y W W W W W W
W W W W b F F F P F F y W W W W W W
W W W W b F F F F F F y W W W W W W
W W W W W W W r r W W W W W W W W W
W W W W W W W r r W W W W W W W W W
W W W W W W W W W W W W W W W W W W
W W W W W W W W W W W W W W W W W W
W W W W W W W W W W W W W W W W W W
W W W W W W W W W W W W W W W W W W