W W W W W W W W W W W W W W W W W W
W W W W W W W W W W W W W W W W W W
W W W W W W W W W W W W W W W W W W
W W W W W W W W W W W W W W W W W W
W W W W W W W W W W W W W W W W W W
W W W W W W W W W W W W W W W W W W
W W W W W F F F F V F F F F W W W W
W W W W F F F F r V y F F F F W W W
W W W W F F P F F V F F B F F W W W
W W W W F F F F F V F F F F F W W W
W W W W F F Y F F V F F R F F W W W
W W W W F F F F b V b F F F F W W W
W W W W W F W W W W W W W F W W W W
W W W W W F F F F F F F F F W W W W
W W W W W W W W W W W W W W W W W W
W W W W W W W W W W W W W W W W W W
W W W W W W W W W W W W W W W W W W
W W W W W W W W W W W W W W W W W W
W W W W W W W W W W W W W W W W W W
W W W W W W W W W W W W W W W W W W