W W W W W W W W W W W W W W W W W W
W W W W W W W W W W W W W W W W W W
W W W W W W W W W W W W W W W W W W
W W W W W W W b b b W W W W W W W W
W W W W W W F F F F F W W W W W W W
W W W W W F F F F F F F W W W W W W
W W W W W F F F F F F F W W W W W W
W W W W W F F B B B F F W W W W W W
W W W W W F F B B B F F W W W W W W
W W W W W F F B B B F F W W W W W W
W W W W W F F F F F F F W W W W W W
W W W W W F F F F F F F W W W W W W
W W W W W W F F F F F W W W W W W W
W W W W W W W F F F W W W W W W W W
W W W W W W W F F F W W W W W W W W
W W W W W W W F P F W W W W W W W W
W W W W W W W F F F W W W W W W W W
W W W W W W W W W W W W W W W W W W
W W W W W W W W W W W W W W W W W W
W W W W W W W W W W W W W W W W W W