W W W W W W W W W W W W W W W W W W
W W W W W W W W W W W W W W W W W W
W W W W W W W W W W W W W W W W W W
W W W W W W W W W W W W W W W W W W
W W W W W W W W W W W W W W W W W W
W W W W W W W F F F W W W W W W W W
W W W W W W W F P F W W W W W W W W
W W W W W W W F F F W W W W W W W W
W W W W W W W F F F V b W W W W W W
W W W W W W W F F F V V Y W W W W W
W W W W W W W F F F V V Y W W W W W
W W W W W W W F F F V V Y W W W W W
W W W W W W W F F F V B Y W W W W W
W W W W W W W F F F F F Y W W W W W
W W W W W r V F F R R R Y W W W W W
W W W W W W W W W W W W W W W W W W
W W W W W W W W W W W W W W W W W W
W W W W W W W W W W W W W W W W W W
W W W W W W W W W W W W W W W W W W
W W W W W W W W W W W W W W W W W W