W W W W W W W W W W W W W W W W W W
W W W W W W W W W W W W W W W W W W
W W W W W W W W W W W W W W W W W W
W W W W W W W W W W W W W W W W W W
W W W W W W W W W W W W W W W W W W
W W W W W W W W W W W W W W W W W W
W W W W W W W W W W W W W W W W W W
W W W W b B V R F F r V F W W W W W
W W W W b F V V V V V V F W W W W W
W W W W b F F F F F F F F W W W W W
W W W W F F F F F F F F F W W W W W
W W W W W W W F F F W W W W W W W W
W W W W W W W F P F W W W W W W W W
W W W W W W W F F F W W W W W W W W
W W W W W W W W W W W W W W W W W W
W W W W W W W W W W W W W W W W W W
W W W W W W W W W W W W W W W W W W
W W W W W W W W W W W W W W W W W W
W W W W W W W W W W W W W W W W W W
W W W W W W W W W W W W W W W W W W