W W W W W W W W W W W W W W W W W W
W W W W W W W W W W W W W W W W W W
W W W W W W W W W W W W W W W W W W
W W W W W W W W W W W W W W W W W W
W W W W W W W W W W W W W W W W W W
W W W W W W W W W W W W W W W W W W
W W W W F F F F F F F F F F W W W W
W W W W F F P F F F b b b b W W W W
W W W W F F F F F F W W W W W W W W
W W W W F F F F F F y y W W W W W W
W W W W F F F F F B y y W W W W W W
W W W W W Y Y W W F W W W W W W W W
W W W W W W F F F F W W W W W W W W
W W W W W W W W W W W W W W W W W W
W W W W W W W W W W W W W W W W W W
W W W W W W W W W W W W W W W W W W
W W W W W W W W W W W W W W W W W W
W W W W W W W W W W W W W W W W W W
W W W W W W W W W W W W W W W W W W
W W W W W W W W W W W W W W W W W W