W W W W W W W W W W W W W W W W W W
W W W W W W W W W W W W W W W W W W
W W W W W W W W W W W W W W W W W W
W W W W W W W W W W W W W W W W W W
W W W W W W W W W W W W W W W W W W
W W W W W W W W W W W W W W W W W W
W W W W F F F V V V F F F W W W W W
W W W y F P F V Y V F F F r W W W W
W W W W F F F V V V F F F W W W W W
W W W W F F F V R V F F F W W W W W
W W W W F F F V F V F F F W W W W W
W W W W F F F F F F F F F W W W W W
W W W W W W W F F F F F F W W W W W
W W W W W W W W W W W W W W W W W W
W W W W W W W W W W W W W W W W W W
W W W W W W W W W W W W W W W W W W
W W W W W W W W W W W W W W W W W W
W W W W W W W W W W W W W W W W W W
W W W W W W W W W W W W W W W W W W
W W W W W W W W W W W W W W W W W W